# arena.txt

# F:letter:feature:cave_info:monster:object:ego:artifact:trap:special

# Permanent wall
F:X:61:131

# Floor
F:.:1:3


D:XXXXXXXXXXXXXXXXXXXXXXXXXXXXXXXXXXXXXXXXXXXXXXXXXXXXXXXXXXXXXXXXXX
D:XXXXXXXXXXXXXXXXXXXXXXXXXXXXXXXXXXXXXXXXXXXXXXXXXXXXXXXXXXXXXXXXXX
D:XXXXXXXXXXXXXXXXXXXXXXXXXXXXXXXXXXXXXXXXXXXXXXXXXXXXXXXXXXXXXXXXXX
D:XXXXXXXXXXXXXXXXXXXXXXXXXXXXXXXXXXXXXXXXXXXXXXXXXXXXXXXXXXXXXXXXXX
D:XXXXXXXXXXXXXXXXXXXXXXXXXXXXXXXXXXXXXXXXXXXXXXXXXXXXXXXXXXXXXXXXXX
D:XXXXXXXXXXXXXXXXXXXXXXXXXXXXXXXXXXXXXXXXXXXXXXXXXXXXXXXXXXXXXXXXXX
D:XXXXXXXXXXXXXXXXXXXXXXXXXXXXXXXXcXXXXXXXXXXXXXXXXXXXXXXXXXXXXXXXXX
D:XXXXXXXXXXXXXXXXXXX............123............XXXXXXXXXXXXXXXXXXXX
D:XXXXXXXXXXXXXXXXXX..............4..............XXXXXXXXXXXXXXXXXXX
D:XXXXXXXXXXXXXXXXXX.............................XXXXXXXXXXXXXXXXXXX
D:XXXXXXXXXXXXXXXXXX.............................XXXXXXXXXXXXXXXXXXX
D:XXXXXXXXXXXXXXXXXX.............................XXXXXXXXXXXXXXXXXXX
D:XXXXXXXXXXXXXXXXXX.............................XXXXXXXXXXXXXXXXXXX
D:XXXXXXXXXXXXXXXXXX.............................XXXXXXXXXXXXXXXXXXX
D:XXXXXXXXXXXXXXXXXXX...........................XXXXXXXXXXXXXXXXXXXX
D:XXXXXXXXXXXXXXXXXXXXXXXXXXXXXXXXXXXXXXXXXXXXXXXXXXXXXXXXXXXXXXXXXX
D:XXXXXXXXXXXXXXXXXXXXXXXXXXXXXXXXXXXXXXXXXXXXXXXXXXXXXXXXXXXXXXXXXX
D:XXXXXXXXXXXXXXXXXXXXXXXXXXXXXXXXXXXXXXXXXXXXXXXXXXXXXXXXXXXXXXXXXX
D:XXXXXXXXXXXXXXXXXXXXXXXXXXXXXXXXXXXXXXXXXXXXXXXXXXXXXXXXXXXXXXXXXX
D:XXXXXXXXXXXXXXXXXXXXXXXXXXXXXXXXXXXXXXXXXXXXXXXXXXXXXXXXXXXXXXXXXX
D:XXXXXXXXXXXXXXXXXXXXXXXXXXXXXXXXXXXXXXXXXXXXXXXXXXXXXXXXXXXXXXXXXX
D:XXXXXXXXXXXXXXXXXXXXXXXXXXXXXXXXXXXXXXXXXXXXXXXXXXXXXXXXXXXXXXXXXX

# Startinng Position
P:7:32
