# arena.txt

# F:letter:feature:cave_info:monster:object:ego:artifact:trap:special

# Permanent wall
F:X:61:131

# Floor
F:.:1:3

# Exit to arena building
F:c:66:3


D:XXXXXXXXXXXXXXXXXXXXXXXXXXXXXXXXXXXXXXXXXXXXXXXXXXXXXXXXXXXXXXXXXX
D:XXXXXXXXXXXXXXXXXXXXXXXXXXXXXXXXXXXXXXXXXXXXXXXXXXXXXXXXXXXXXXXXXX
D:XXXXXXXXXXXXXXXXXXXXXXXXXXXXXXXXXXXXXXXXXXXXXXXXXXXXXXXXXXXXXXXXXX
D:XXXXXXXXXXXXXXXXXXXXXXXXXXXXXXXXXXXXXXXXXXXXXXXXXXXXXXXXXXXXXXXXXX
D:XXXXXXXXXXXXXXXXXXXXXXXXXXXXXXXXXXXXXXXXXXXXXXXXXXXXXXXXXXXXXXXXXX
D:XXXXXXXXXXXXXXXXXXXXXXXXXXXXXXXXXXXXXXXXXXXXXXXXXXXXXXXXXXXXXXXXXX
D:XXXXXXXXXXXXXXXXXXXXXXXXXXXXXXXXcXXXXXXXXXXXXXXXXXXXXXXXXXXXXXXXXX
D:XXXXXXXXXXXXXXXXXXX...........................XXXXXXXXXXXXXXXXXXXX
D:XXXXXXXXXXXXXXXXXX.............................XXXXXXXXXXXXXXXXXXX
D:XXXXXXXXXXXXXXXXXX.............................XXXXXXXXXXXXXXXXXXX
D:XXXXXXXXXXXXXXXXXX.............................XXXXXXXXXXXXXXXXXXX
D:XXXXXXXXXXXXXXXXXX.............................XXXXXXXXXXXXXXXXXXX
D:XXXXXXXXXXXXXXXXXX.............................XXXXXXXXXXXXXXXXXXX
D:XXXXXXXXXXXXXXXXXX.............................XXXXXXXXXXXXXXXXXXX
D:XXXXXXXXXXXXXXXXXXX...........................XXXXXXXXXXXXXXXXXXXX
D:XXXXXXXXXXXXXXXXXXXXXXXXXXXXXXXXXXXXXXXXXXXXXXXXXXXXXXXXXXXXXXXXXX
D:XXXXXXXXXXXXXXXXXXXXXXXXXXXXXXXXXXXXXXXXXXXXXXXXXXXXXXXXXXXXXXXXXX
D:XXXXXXXXXXXXXXXXXXXXXXXXXXXXXXXXXXXXXXXXXXXXXXXXXXXXXXXXXXXXXXXXXX
D:XXXXXXXXXXXXXXXXXXXXXXXXXXXXXXXXXXXXXXXXXXXXXXXXXXXXXXXXXXXXXXXXXX
D:XXXXXXXXXXXXXXXXXXXXXXXXXXXXXXXXXXXXXXXXXXXXXXXXXXXXXXXXXXXXXXXXXX
D:XXXXXXXXXXXXXXXXXXXXXXXXXXXXXXXXXXXXXXXXXXXXXXXXXXXXXXXXXXXXXXXXXX
D:XXXXXXXXXXXXXXXXXXXXXXXXXXXXXXXXXXXXXXXXXXXXXXXXXXXXXXXXXXXXXXXXXX

# Starting Position
P:7:32
